10000,0,250,800,1050,1050,Success
10001,0,250,801,1051,1051,Success
10002,0,250,900,1150,1150,Success
10003,0,250,899,1149,1149,Success
10004,0,200,850,1050,1050,Success
10005,0,201,850,1051,1051,Success
10006,0,300,850,1150,1150,Success
10007,0,299,850,1149,1149,Success
10008,-100,250,850,1000,1000,Success
10009,-99,250,850,1001,1001,Success
10010,100,250,850,1200,1200,Success
10011,99,250,850,1199,1199,Success
10012,0,250,850,1100,1100,Success
